R 1200 900
NO ./texture/wall_1.xpm
SO ./texture/wall_2.xpm
WE ./texture/wall_3.xpm
EA ./texture/wall_4.xpm

S ./texture/barrel.xpm
F 128,128,128
C 0,0,0

1111111
1000001
1000201
1002001
1000001
10N0001
1111111