NO ./texture/wall_n.xpm
SO ./texture/wall_s.xpm
WE ./texture/wall_w.xpm
EA ./texture/wall_e.xpm

F 128,128,12
C 1,2,3

        1111111111111111111111111
        1000000000110000000000001
        1011000001110000000000001
        1001000000000000000000001
111111111011000001110000000000001
100000000011000001110111111111111
11110111111111011100000010001
11110111111111011101010010001
11000000110101011100000010001
10000000000000001100000010001
1000000000000000110101N000001
110000011101010111110111100111
11110111 1110101 101111010001
11111111 1111111 111111111111
 11 1